==========================================================================
|   +                                                                    |
|   ++++++++++++++++++++++++++++++++++++++                               |
|=======================================================                 |
|                                                                        |
|   *                                       *                            |
|                                                                        |
|                         *                                              |
|           =======================================================      |
|                                                                        |
|        *                                                               |
|                                                                        |
|==========================================================              |
|                                                                        |
|                     *                      *                           |
|                                                                        |
|        =======================================================         |
|                                                                        |
|            *                 *                     *                   |
|                                                                        |
==========================================================================
==========================================================================
|   +                                                                    |
|   +++++++++++++++++++++++++++++++++++++++++++++++++++++                |
|=======================================================+                |
|                                                       +                |
|   +++++++++++++++++++++++++++++++++++++++++++++++++++++                |
|                                                                        |
|                         *                                              |
|           =======================================================      |
|                                                                        |
|        *                                                               |
|                                                                        |
|==========================================================              |
|                                                                        |
|                     *                      *                           |
|                                                                        |
|        =======================================================         |
|                                                                        |
|            *                 *                     *                   |
|                                                                        |
==========================================================================
==========================================================================
|   +                                                                    |
|   +++++++++++++++++++++++++++++++++++++++++++++++++++++                |
|=======================================================+                |
|                                                       +                |
|   *                                       +++++++++++++                |
|                                                                        |
|                         *                                              |
|           =======================================================      |
|                                                                        |
|        *                                                               |
|                                                                        |
|==========================================================              |
|                                                                        |
|                     *                      *                           |
|                                                                        |
|        =======================================================         |
|                                                                        |
|            *                 *                     *                   |
|                                                                        |
==========================================================================
==========================================================================
|   +                                                                    |
|   +++++++++++++++++++++++++++++++++++++++++++++++++++++                |
|=======================================================+                |
|                                                       +                |
|   *                                       *           +                |
|                                                       +                |
|                         +++++++++++++++++++++++++++++++                |
|           =======================================================      |
|                                                                        |
|        *                                                               |
|                                                                        |
|==========================================================              |
|                                                                        |
|                     *                      *                           |
|                                                                        |
|        =======================================================         |
|                                                                        |
|            *                 *                     *                   |
|                                                                        |
==========================================================================
==========================================================================
|   +                                                                    |
|   +++++++++++++++++++++++++++++++++++++++++++++++++++++                |
|=======================================================+                |
|                                                       +                |
|   *                                       *           +                |
|                                                       +                |
|          ++++++++++++++++++++++++++++++++++++++++++++++                |
|          +=======================================================      |
|          +                                                             |
|        +++                                                             |
|                                                                        |
|==========================================================              |
|                                                                        |
|                     *                      *                           |
|                                                                        |
|        =======================================================         |
|                                                                        |
|            *                 *                     *                   |
|                                                                        |
==========================================================================
==========================================================================
|   +                                                                    |
|   +++++++++++++++++++++++++++++++++++++++++++++++++++++                |
|=======================================================+                |
|                                                       +                |
|   *                                       *           +                |
|                                                       +                |
|                         *                             ++++++++++++     |
|           =======================================================+     |
|                                                                  +     |
|        *                                                         +     |
|                                                                  +     |
|==========================================================        +     |
|                                                                  +     |
|                     ++++++++++++++++++++++++++++++++++++++++++++++     |
|                                                                        |
|        =======================================================         |
|                                                                        |
|            *                 *                     *                   |
|                                                                        |
==========================================================================
==========================================================================
|   +                                                                    |
|   +++++++++++++++++++++++++++++++++++++++++++++++++++++                |
|=======================================================+                |
|                                                       +                |
|   *                                       *           +                |
|                                                       +                |
|                         *                             ++++++++++++     |
|           =======================================================+     |
|                                                                  +     |
|        *                                                         +     |
|                                                                  +     |
|==========================================================        +     |
|                                                                  +     |
|                     *                      +++++++++++++++++++++++     |
|                                                                        |
|        =======================================================         |
|                                                                        |
|            *                 *                     *                   |
|                                                                        |
==========================================================================
==========================================================================
|   +                                                                    |
|   +++++++++++++++++++++++++++++++++++++++++++++++++++++                |
|=======================================================+                |
|                                                       +                |
|   *                                       *           +                |
|                                                       +                |
|                         *                             ++++++++++++     |
|           =======================================================+     |
|                                                                  +     |
|        *                                                         +     |
|                                                                  +     |
|==========================================================        +     |
|                                                                  +     |
|                     *                      *                     +     |
|                                                                  +     |
|        =======================================================   +     |
|                                                                  +     |
|            +++++++++++++++++++++++++++++++++++++++++++++++++++++++     |
|                                                                        |
==========================================================================
==========================================================================
|   +                                                                    |
|   +++++++++++++++++++++++++++++++++++++++++++++++++++++                |
|=======================================================+                |
|                                                       +                |
|   *                                       *           +                |
|                                                       +                |
|                         *                             ++++++++++++     |
|           =======================================================+     |
|                                                                  +     |
|        *                                                         +     |
|                                                                  +     |
|==========================================================        +     |
|                                                                  +     |
|                     *                      *                     +     |
|                                                                  +     |
|        =======================================================   +     |
|                                                                  +     |
|            *                 +++++++++++++++++++++++++++++++++++++     |
|                                                                        |
==========================================================================
==========================================================================
|   +                                                                    |
|   +++++++++++++++++++++++++++++++++++++++++++++++++++++                |
|=======================================================+                |
|                                                       +                |
|   *                                       *           +                |
|                                                       +                |
|                         *                             ++++++++++++     |
|           =======================================================+     |
|                                                                  +     |
|        *                                                         +     |
|                                                                  +     |
|==========================================================        +     |
|                                                                  +     |
|                     *                      *                     +     |
|                                                                  +     |
|        =======================================================   +     |
|                                                                  +     |
|            *                 *                     +++++++++++++++     |
|                                                                        |
==========================================================================
