==========================================================================
|  +                              |                                      |
|  +++++++++++++++++++            |                                      |
|====================+            |                                      |
|                    +                                                   |
|                    ++++++++++++++++++++++++++++++++++++++++++          |
|                  ===================                                   |
|                                                                        |
|                                                                        |
|                                                                        |
|                *                    ==========================         |
|                                                                        |
|                                                                        |
|                                               |                        |
|================================               |                        |
|                                               |                        |
|                     *                         |                        |
|                                               |                        |
|                                               |                        |
|                                               |                       *|
==========================================================================
==========================================================================
|  +                              |                                      |
|  +++++++++++++++++++            |                                      |
|====================+            |                                      |
|                    +                                                   |
|                 ++++                                        *          |
|                 +===================                                   |
|                 +                                                      |
|                 +                                                      |
|                 +                                                      |
|                ++                   ==========================         |
|                                                                        |
|                                                                        |
|                                               |                        |
|================================               |                        |
|                                               |                        |
|                     *                         |                        |
|                                               |                        |
|                                               |                        |
|                                               |                       *|
==========================================================================
==========================================================================
|  +                              |                                      |
|  +++++++++++++++++++            |                                      |
|====================+            |                                      |
|                    +                                                   |
|                 ++++                                        *          |
|                 +===================                                   |
|                 +                                                      |
|                 +                                                      |
|                 +                                                      |
|                *+                   ==========================         |
|                 +                                                      |
|                 +                                                      |
|                 ++++++++++++++++              |                        |
|================================+              |                        |
|                                +              |                        |
|                     ++++++++++++              |                        |
|                                               |                        |
|                                               |                        |
|                                               |                       *|
==========================================================================
==========================================================================
|  +                              |                                      |
|  +++++++++++++++++++            |                                      |
|====================+            |                                      |
|                    +                                                   |
|                    ++++++++++++++++++                       *          |
|                  ===================+                                  |
|                                     +                                  |
|                                     +                                  |
|                                     +++++++++++++++++++++++++++        |
|                *                    ==========================+        |
|                                                               +        |
|                                                               +        |
|                                               |               +        |
|================================               |               +        |
|                                               |               +        |
|                     *                         |               +        |
|                                               |               +        |
|                                               |               +        |
|                                               |               +++++++++|
==========================================================================
