==========================================================================
|   ++++++++++++++++++++++++++++++++++++++                               |
|                                        +                               |
|=======================================================                 |
|                                                                        |
|   *                                       *                            |
|                                                                        |
|                         *                                              |
|           =======================================================      |
|                                                                        |
|        *                                                               |
|                                                                        |
|==========================================================              |
|                                                                        |
|                     *                      *                           |
|                                                                        |
|        =======================================================         |
|                                                                        |
|            *                 *                     *                   |
|                                                                        |
==========================================================================
==========================================================================
|   +++++++++++++++++++++++++++++++++++++++++++++++++++++++++++++++++++++|
|                                        *                              +|
|=======================================================+++++++++++++++++|
|   +++++++++++++++++++++++++++++++++++++++++++++++++++++                |
|   +                                       *                            |
|                                                                        |
|                         *                                              |
|           =======================================================      |
|                                                                        |
|        *                                                               |
|                                                                        |
|==========================================================              |
|                                                                        |
|                     *                      *                           |
|                                                                        |
|        =======================================================         |
|                                                                        |
|            *                 *                     *                   |
|                                                                        |
==========================================================================
==========================================================================
|   +++++++++++++++++++++++++++++++++++++++++++++++++++++++++++++++++++++|
|                                        *                              +|
|=======================================================+++++++++++++++++|
|                                           +++++++++++++                |
|   *                                       +                            |
|                                                                        |
|                         *                                              |
|           =======================================================      |
|                                                                        |
|        *                                                               |
|                                                                        |
|==========================================================              |
|                                                                        |
|                     *                      *                           |
|                                                                        |
|        =======================================================         |
|                                                                        |
|            *                 *                     *                   |
|                                                                        |
==========================================================================
==========================================================================
|   +++++++++++++++++++++++++++++++++++++++++++++++++++++++++++++++++++++|
|                                        *                              +|
|=======================================================+++++++++++++++++|
|++++++++++++++++++++++++++++++++++++++++++++++++++++++++                |
|+  *                                       *                            |
|++++++++++++++++++++++++++                                              |
|                         +                                              |
|           =======================================================      |
|                                                                        |
|        *                                                               |
|                                                                        |
|==========================================================              |
|                                                                        |
|                     *                      *                           |
|                                                                        |
|        =======================================================         |
|                                                                        |
|            *                 *                     *                   |
|                                                                        |
==========================================================================
==========================================================================
|   +++++++++++++++++++++++++++++++++++++++++++++++++++++++++++++++++++++|
|                                        *                              +|
|=======================================================+++++++++++++++++|
|++++++++++++++++++++++++++++++++++++++++++++++++++++++++                |
|+  *                                       *                            |
|++++++++++++++++++++++++++++++++++++++++++++++++++++++++++++++++++++++++|
|                         *                                             +|
|           =======================================================++++++|
|        +++++++++++++++++++++++++++++++++++++++++++++++++++++++++++     |
|        +                                                               |
|                                                                        |
|==========================================================              |
|                                                                        |
|                     *                      *                           |
|                                                                        |
|        =======================================================         |
|                                                                        |
|            *                 *                     *                   |
|                                                                        |
==========================================================================
==========================================================================
|   +++++++++++++++++++++++++++++++++++++++++++++++++++++++++++++++++++++|
|                                        *                              +|
|=======================================================+++++++++++++++++|
|++++++++++++++++++++++++++++++++++++++++++++++++++++++++                |
|+  *                                       *                            |
|++++++++++++++++++++++++++++++++++++++++++++++++++++++++++++++++++++++++|
|                         *                                             +|
|           =======================================================++++++|
|+++++++++++++++++++++++++++++++++++++++++++++++++++++++++++++++++++     |
|+       *                                                               |
|++++++++++++++++++++++++++++++++++++++++++++++++++++++++++++++++++++++++|
|==========================================================             +|
|                     +++++++++++++++++++++++++++++++++++++++++++++++++++|
|                     +                      *                           |
|                                                                        |
|        =======================================================         |
|                                                                        |
|            *                 *                     *                   |
|                                                                        |
==========================================================================
==========================================================================
|   +++++++++++++++++++++++++++++++++++++++++++++++++++++++++++++++++++++|
|                                        *                              +|
|=======================================================+++++++++++++++++|
|++++++++++++++++++++++++++++++++++++++++++++++++++++++++                |
|+  *                                       *                            |
|++++++++++++++++++++++++++++++++++++++++++++++++++++++++++++++++++++++++|
|                         *                                             +|
|           =======================================================++++++|
|+++++++++++++++++++++++++++++++++++++++++++++++++++++++++++++++++++     |
|+       *                                                               |
|++++++++++++++++++++++++++++++++++++++++++++++++++++++++++++++++++++++++|
|==========================================================             +|
|                                            ++++++++++++++++++++++++++++|
|                     *                      +                           |
|                                                                        |
|        =======================================================         |
|                                                                        |
|            *                 *                     *                   |
|                                                                        |
==========================================================================
==========================================================================
|   +++++++++++++++++++++++++++++++++++++++++++++++++++++++++++++++++++++|
|                                        *                              +|
|=======================================================+++++++++++++++++|
|++++++++++++++++++++++++++++++++++++++++++++++++++++++++                |
|+  *                                       *                            |
|++++++++++++++++++++++++++++++++++++++++++++++++++++++++++++++++++++++++|
|                         *                                             +|
|           =======================================================++++++|
|+++++++++++++++++++++++++++++++++++++++++++++++++++++++++++++++++++     |
|+       *                                                               |
|++++++++++++++++++++++++++++++++++++++++++++++++++++++++++++++++++++++++|
|==========================================================             +|
|++++++++++++++++++++++++++++++++++++++++++++++++++++++++++++++++++++++++|
|+                    *                      *                           |
|++++++++++++++++++++++++++++++++++++++++++++++++++++++++++++++++++++++++|
|        =======================================================        +|
|            ++++++++++++++++++++++++++++++++++++++++++++++++++++++++++++|
|            +                 *                     *                   |
|                                                                        |
==========================================================================
==========================================================================
|   +++++++++++++++++++++++++++++++++++++++++++++++++++++++++++++++++++++|
|                                        *                              +|
|=======================================================+++++++++++++++++|
|++++++++++++++++++++++++++++++++++++++++++++++++++++++++                |
|+  *                                       *                            |
|++++++++++++++++++++++++++++++++++++++++++++++++++++++++++++++++++++++++|
|                         *                                             +|
|           =======================================================++++++|
|+++++++++++++++++++++++++++++++++++++++++++++++++++++++++++++++++++     |
|+       *                                                               |
|++++++++++++++++++++++++++++++++++++++++++++++++++++++++++++++++++++++++|
|==========================================================             +|
|++++++++++++++++++++++++++++++++++++++++++++++++++++++++++++++++++++++++|
|+                    *                      *                           |
|++++++++++++++++++++++++++++++++++++++++++++++++++++++++++++++++++++++++|
|        =======================================================        +|
|                              ++++++++++++++++++++++++++++++++++++++++++|
|            *                 +                     *                   |
|                                                                        |
==========================================================================
==========================================================================
|   +++++++++++++++++++++++++++++++++++++++++++++++++++++++++++++++++++++|
|                                        *                              +|
|=======================================================+++++++++++++++++|
|++++++++++++++++++++++++++++++++++++++++++++++++++++++++                |
|+  *                                       *                            |
|++++++++++++++++++++++++++++++++++++++++++++++++++++++++++++++++++++++++|
|                         *                                             +|
|           =======================================================++++++|
|+++++++++++++++++++++++++++++++++++++++++++++++++++++++++++++++++++     |
|+       *                                                               |
|++++++++++++++++++++++++++++++++++++++++++++++++++++++++++++++++++++++++|
|==========================================================             +|
|++++++++++++++++++++++++++++++++++++++++++++++++++++++++++++++++++++++++|
|+                    *                      *                           |
|++++++++++++++++++++++++++++++++++++++++++++++++++++++++++++++++++++++++|
|        =======================================================        +|
|                                                    ++++++++++++++++++++|
|            *                 *                     +                   |
|                                                                        |
==========================================================================
