==========================================================================
|  +++++++++++++++++++++++++++++++|                                      |
|                                +|                                      |
|====================+++++++++++++|                                      |
|+++++++++++++++++++++                                                   |
|+                                                            +++++++++++|
|++++++++++++++++++===================                                  +|
|                 +++++++++++++++++++++++++++++++++++++++++++++++++++++++|
|                                                                        |
|                                                                        |
|                *                    ==========================         |
|                                                                        |
|                                                                        |
|                                               |                        |
|================================               |                        |
|                                               |                        |
|                     *                         |                        |
|                                               |                        |
|                                               |                        |
|                                               |                       *|
==========================================================================
==========================================================================
|  +++++++++++++++++++++++++++++++|                                      |
|                                +|                                      |
|====================+++++++++++++|                                      |
|+++++++++++++++++++++                                                   |
|+                                                            *          |
|++++++++++++++++++===================                                   |
|                 +++++++++++++++++++++++++++++++++++++++++++++++++++++++|
|                                                                       +|
|                ++++++++++++++++++++++++++++++++++++++++++++++++++++++++|
|                +                    ==========================         |
|                                                                        |
|                                                                        |
|                                               |                        |
|================================               |                        |
|                                               |                        |
|                     *                         |                        |
|                                               |                        |
|                                               |                        |
|                                               |                       *|
==========================================================================
==========================================================================
|  +++++++++++++++++++++++++++++++|                                      |
|                                +|                                      |
|====================+++++++++++++|                                      |
|+++++++++++++++++++++                                                   |
|+                                                            *          |
|++++++++++++++++++===================                                   |
|                 +++++++++++++++++++++++++++++++++++++++++++++++++++++++|
|                                                                       +|
|++++++++++++++++++++++++++++++++++++++++++++++++++++++++++++++++++++++++|
|+               *                    ==========================         |
|+++++++++++++++++++++++++++++++++++++++++++++++                         |
|                                              +                         |
|                                +++++++++++++++|                        |
|================================+              |                        |
|                     ++++++++++++              |                        |
|                     +                         |                        |
|                                               |                        |
|                                               |                        |
|                                               |                       *|
==========================================================================
==========================================================================
|  +++++++++++++++++++++++++++++++|                                      |
|                                +|                                      |
|====================+++++++++++++|                                      |
|+++++++++++++++++++++                                                   |
|+                                                            *          |
|++++++++++++++++++===================                                   |
|                 +++++++++++++++++++++++++++++++++++++++++++++++++++++++|
|                                                                       +|
|++++++++++++++++++++++++++++++++++++++++++++++++++++++++++++++++++++++++|
|+               *                    ==========================         |
|++++++++++++++++++++++++++++++++++++++++++++++++++++++++++++++++++++++++|
|                                                                       +|
|                                               |++++++++++++++++++++++++|
|================================               |+                       |
|                                               |++++++++++++++++++++++++|
|                     *                         |                       +|
|                                               |++++++++++++++++++++++++|
|                                               |+                       |
|                                               |++++++++++++++++++++++++|
==========================================================================
