==========================================================================
|  s++++++++++++++++++++++++++++++|                                      |
|                                +|                                      |
|====================            +|                                      |
|                                ++++++++++++++++++++++++++++++          |
|                                                             +          |
|                  ===================                                   |
|                                                                        |
|                                                                        |
|                                                                        |
|                *                    ==========================         |
|                                                                        |
|                                                                        |
|                                               |                        |
|================================               |                        |
|                                               |                        |
|                     *                         |                        |
|                                               |                        |
|                                               |                        |
|                                               |                       *|
==========================================================================
==========================================================================
|  s++++++++++++++++++            |                                      |
|                    +            |                                      |
|====================+            |                                      |
|                +++++                                                   |
|                +                                            *          |
|                + ===================                                   |
|                +                                                       |
|                +                                                       |
|                +                                                       |
|                +                    ==========================         |
|                                                                        |
|                                                                        |
|                                               |                        |
|================================               |                        |
|                                               |                        |
|                     *                         |                        |
|                                               |                        |
|                                               |                        |
|                                               |                       *|
==========================================================================
==========================================================================
|  s++++++++++++++++++            |                                      |
|                    +            |                                      |
|====================+            |                                      |
|                 ++++                                                   |
|                 +                                           *          |
|                 +===================                                   |
|                 ++++++++++++++++                                       |
|                                +                                       |
|                                +                                       |
|                *               +    ==========================         |
|                                +                                       |
|                                +                                       |
|                                +              |                        |
|================================+              |                        |
|                     ++++++++++++              |                        |
|                     +                         |                        |
|                                               |                        |
|                                               |                        |
|                                               |                       *|
==========================================================================
==========================================================================
|  s++++++++++++++++++++++++++++++|                                      |
|                                +|                                      |
|====================            +|                                      |
|                                ++++++++++++++++++++++++++++++++++++++++|
|                                                             *         +|
|                  ===================                                  +|
|                                                                       +|
|                                                                       +|
|                                                                       +|
|                *                    ==========================        +|
|                                                                       +|
|                                                                       +|
|                                               |                       +|
|================================               |                       +|
|                                               |                       +|
|                     *                         |                       +|
|                                               |                       +|
|                                               |                       +|
|                                               |                       +|
==========================================================================
